#.................................................
..................................................
..................................................
..................................................
...#..............................................
....#.............................................
.....#............................................
......#...........................................
......#...........................................
.......#..........................................
........#.........................................
........##........................................
.........##.......................................
..........##......................................
...........##.....................................
...........##.....................................
............##....................................
.............##...................................
..............##..................................
..............###.................................
...............###................................
................###...............................
................####..............................
.................###..............................
..................###.............................
...................###............................
...................####...........................
....................####..........................
.....................####.........................
......................####........................
......................####........................
.......................####.......................
........................####......................
........................#####.....................
.........................#####....................
..........................#####...................
...........................#####..................
...........................#####..................
............................#####.................
.............................#####................
..............................#####...............
..............................######..............
...............................######.............
................................######............
................................#######...........
.................................######...........
..................................######..........
...................................######.........
...................................#######........
....................................#######.......